だ・です - to be
だけ - only; just; as much as
だろう - I think; it seems; probably; right?
で - in; at; on; by; with; via
でも - but; however
でしょう - I think; it seems; probably; right?
どんな - what kind of; what sort of
どうして - why; for what reason; how
どうやって - how; in what way; by what means
が - subject marker; however; but
があります - there is; is (non-living things)
がほしい - to want something
がいます - there is; to be; is (living things)
ほうがいい - had better; it'd be better to; should~
い-adjectives - i-adjectives
一番 - the most; the best
一緒に - together
いつも - always; usually; habitually
じゃない・ではない - to not be (am not; is not; are not)
か - question particle
か〜か - or
から - because; since; from
方 - the way of doing something; how to do
けど - but; however; although
けれども - but; however; although
まだ - still; not yet
まだ〜ていません - have not yet
まで - until ~; as far as ~; to (an extent); even ~
前に - before ~; in front of ~
ませんか - would you; do you want to; shall we~
ましょう - let's ~; shall we ~
ましょうか - shall I ~; used to offer help to the listener
も - too; also; as well
もう - already; anymore; again; other
な-adjectives - na-adjectives
なあ - "sentence ending particle; confirmation; admiration
ないで - without doing~ ; To do [B] without doing [A]
ないでください - please don't do
なくてもいい - don't have to
なくちゃ - must do; need to; gotta do
なくてはいけない - must do; need to do
なくてはならない - must do; need to do
なる - to become
んです - to explain something; show emphasis
ね - isn't it? right? eh?
に - destination particle; in; at; on; to
にいく - go to do
にする - to decide on
に/へ - to (indicates direction / destination)
の - possessive particle
のです - to explain something; show emphasis
のが下手 - to be bad at doing something
のが上手 - to be good at
のが好き - to like doing something
の中で[A]が一番 - "out of this group
ので - because of; given that; since
を - object marker particle
をください - please give me~
しかし - but; however
すぎる - too much
たことがある - to have done something before
たい - want to do something
たり〜たり - do such things as A and B
てある - is/has been done (resulting state)
ている - ongoing action or current state
てから - after doing~
てください - please do
てはいけない - must not; may not; cannot
ちゃいけない・じゃいけない - must not do (spoken Japanese)
てもいいです - is OK to..; is alright to..; may I..?
と - and; with; as; connecting particle
とき - when; at this time
とても - very; awfully; exceedingly
つもり - plan to ~; intend to ~
は - topic marker
は〜より・・・です - [A] is more ~ than [B]
はどうですか - how about; how is
や - and; or; connecting particle
よ - you know; emphasis (ending particle)
より〜ほうが - [A] is more than [B]
間 - while; during; between
間に - while/during~ something happened
あまり～ない - "not very
後で - after ~; later
ば - conditional form; If [A] then [B]
場合は - in the event of; in the case that
ばかり - only; nothing but
だけで - just by; just by doing
出す - to suddenly begin; to suddenly appear
でございます - to be (honorific)
でも - ... or something
ではないか - right?; isn't it?
が必要 - need; necessary
がする - to smell; hear; taste
がり - personality; tend to~; sensitivity towards~
がる・がっている - to show signs of; to appear; to feel
ございます - "to be
始める - to start; to begin to ~
はずだ - it must be; it should be (expectation)
はずがない - cannot be (impossible)
必要がある - need to; it is necessary to
意向形 - volitional form; let's do ~
いらっしゃる - to be; to come; to go (polite version)
いたします - to do (polite form of する)
じゃないか - right? isn't it? let's~; confirmation
かどうか - whether or not
かしら - I wonder
かい - turns a sentence into a yes/no question
かもしれない - might; perhaps; indicates possibility
かな - I wonder; should I?
から作る - made from; made with
きっと - surely; undoubtedly; certainly; likely
頃 - around; about; when
こと - Verb nominalizer
ことがある - there are times when
ことができる - can; able to
ことになる - It has been decided that..; it turns out ~
ことにする - to decide on
くする - to make something ~
急に - suddenly
までに - by; by the time; indicates time limit
まま - as it is; current state; without changing
または - both; or; otherwise; choice of [A] or [B]
みたいだ - "like
みたいな - "like
みたいに - "like
も - as many as; as much as; up to; nearly
な - don’t ~ (order somebody to not do ~)
など - "such as
ながら - while; during; as; simultaneously
なかなか～ない - not easy to; struggling to; not able to~
なければいけない - must do something; have to do something
なければならない - must do something; have to do something
なら - if; in the case that ~
なさい - do this (soft/firm command)
なさる - to do (honorific)
に気がつく - to notice; to realize
にみえる - to look; to seem; to appear
にする - to make something ~
にくい - difficult to do
の中で - "in
のに - "although
のに - to (do something); in order to
のは〜だ - [A] is [B]; the reason for [A] is [B]
お～ください - please do (honorific)
お～になる - to do (honorific)
おきに - "repeated at intervals
終わる - to finish; to end
られる - potential form; ability/inability to do ~
らしい - it seems like; I heard; apparently~
さ - -ness ; nominalizer for adjective
さっき - some time ago; just now
させられる - causative-passive; to be made to do ~
させる - causative form; to make/let somebody do
させてください - please let me do
さすが - as one would expect; as is to be expected
し - and; and what’s more; emphasis
そんなに - so much; so; like that
それでも - but still; and yet; even so
そうだ - I heard that; it is said that
そうだ - looks like; appears like
そうに・そうな - seems like; looks like
たばかり - just finished; something just occurred
たところ - "just finished doing
他動詞 & 自動詞 - Transitive & Intransitive Verbs
たがる - wants to do~ (third person)
たら - "if
たらどう - why don't you
たらいいですか - what should I do?; seeking instruction
て / で - "conjunctive; so; because of [A]
てあげる - to do for; to do a favor
てほしい - I want you to; need you to~
ていく - to start; to continue; to go on
ていた - was doing something (past continuous)
ていただけませんか - could you please
てくれる - to do a favor; do something for someone
てくる - to do… and come back; to continue
てみる - try doing
てもらう - to get somebody to do something
ておく - to do something in advance
てしまう / ちゃう - "to do something by accident
てすみません - I’m sorry for
てやる - to do for; to do a favor (casual)
てよかった - I’m glad that..
ているところ - in the process of doing
ても - even; even if; even though
と - "whenever [A] happens
と言ってもいい - you could say; one might say; I'd say
という - called; named; that
ということ - convert phrase into noun
と言われている - it is said that...
と聞いた - I heard...
と思う - to think…; I think…; you think…
とか～とか - among other things; such as; like
ところ - just about to; on the verge of doing ~
続ける - continue to; keen on
って - named; called
受身形 - passive form; passive voice
は〜が… は - [A] but [B]; however; comparison
やすい - easy to; likely to; prone to; a tendency to~
やっと - at last; finally; barely; narrowly
より - than; rather than; more than
予定だ - "plan to
ようだ - appears; seems; looks as if
ように / ような - like; as; similar to
ようになる - to reach the point that; to turn into
ようにする - to try to; to make sure that
ようと思う - thinking of doing; planning to
ぜひ - by all means; certainly; definitely
全然～ない - (not) at all
づらい - difficult to do
上げる - to finish doing~
あまり - so much… that
あまりにも - too…; so much… that; excessively~
合う - do something together
ばいい - "should
ばよかった - "should have
ば～ほど - the more… the more
ば～のに - would have; should have; if only~
ばかりで - only; just (negative description)
ばかりでなく - not only.. but also; as well as
べきだ - should do~; must do~
べきではない - should not do~; must not do~
別に～ない - "not really
ぶりに - for the first time in (period of time)
中 - currently; during; throughout
だけ - as much as~
だけでなく - not only… but also
だけど - however; but
だらけ - full of; covered with; a lot of~
どんなに～ても - no matter how (much)
どうしても - no matter what; at any cost; after all
ふりをする - to pretend; to act as if~
ふと - suddenly; accidentally; unexpectedly
がち - tend to; tendency to; frequently; often~
がたい - very difficult to; impossible to
気味 - -like; -looking; -looked; tending to
ごとに - each; every; at intervals of
ほど - degree; extent; bounds; upper limit
ほど～ない - is not as… as
一度に - all at once
いくら～ても - no matter how~
一方だ - more and more; continue to
一体 - emphasis; what on earth?
じゃない - maybe; most likely; confirmation
か何か - or something
かける - half-; not yet finished; in the middle of~
から〜にかけて - through; from [A] to [B]
代わりに - instead of; in exchange for~
結果 - as a result of; after
結局 - after all; eventually; in the end
決して～ない - never; by no means
切れない - unable to do; too much to finish
きり - only; just; since; after
切る - to do something completely to the end
っけ - casual suffix to confirm something
込む - Move inside; do a long time
こそ - for sure; precisely; definitely
こと - (must) do
ことから - from the fact that~
ことになっている - to be expected to; it has been decided~
ことはない - there is no need to; no possibility that~
ことは～が - although; but
くらい・ぐらい - approximately; about; to the extent
くせに - although~; despite the fact that~
まるで - as if; as though; just like
まさか - there's no way; that's impossible
めったに～ない - hardly; rarely; seldom
も～ば～も - and; also; as well; either/or; neither
もしかしたら - perhaps; maybe; perchance; by chance
もしも〜たら - if; in the case; supposing~
向け - intended for; aimed at~
向き - suitable for~
むしろ - rather; instead; better
ながらも - but; although; despite
ないことはない - can do~; is not impossible to~
ないと - must do; unless/if you don't~
なかなか - quite~; pretty~; rather~; just not ~
なんか / なんて - examples; modesty; make light of~
直す - to do something again; to do over
なるべく - as much as possible
なぜなら - because; the reason is
んだって - I hear that; heard that~
に違いない - I’m sure/ certain; no doubt that
に反して - against; contrary to; in contrast to
にかけて - over (a period); concerning; regarding~
に関する - about; regarding; related to
にかわって - instead of~; replacing~; on behalf of~
に比べて - compared to~; in comparison to~
に慣れる - to be used to something
において - in; at (place); regarding~; as for~
にしたがって - as; therefore; in accordance with
にしても - even if; even though; regardless of
にしては - for; considering it’s
に対して - towards; against; regarding~
にとって - to; for; concerning; regarding~
について - concerning; regarding; about; on
につれて - as; in proportion to; with; as… then…
には - for the purpose of; in order to~
によると /によれば - according to~
によって / による - by means of; due to; because of~
のでしょうか - ask a question in a polite way
を中心に - focused on; centered on
をはじめ - for example; starting with
を込めて - filled with; full of
を通じて /を通して - through; via; throughout; by
おかげで - thanks to ...; owing to ...; because of ...
っぱなし - leaving (something) on / still in use
っぽい - seems; somewhat; -ish; easily does~;
さえ - even; so much as; not even
さえ～ば - if only; as long as
際に - when; at the time of; in the case of
最中に - while; during; in the middle of
さらに - furthermore; again; more and more
さて - conjunction: well; now; then
せいで - because of; due to; as a result of~
せいぜい - at the most; at best; to the utmost
しばらく - for a moment; for a while
しかない - have no choice but~
そのために - hence; for that reason; because of~
それとも - or; or else
そうもない - very unlikely to~; showing no signs of~
すでに - something has already been done
すなわち - in other words; namely
数量 + は - at least
たものだ - used to do; would often do
たとたん - as soon as; just as
たびに - whenever; every time
ために - for; in order to; for the benefit of
確かに - "surely
たて - just done; freshly done; newly done
たとえ～ても - even if… is the case
例えば - for example
たって - even if; even though; no matter how
てばかりいる - only; nothing but~
てごらん - (please) try to; (please) look
てはじめて - not until; only after [x] did I
てからでないと - must first do; cannot do without~
てしょうがない - can't help but~; very; extremely
て済む - sufficient by; resolve by~
てはいけないから - in order to not~
ている場合じゃない - this is no time to be doing~
的 - change noun into na-adjective
ても始まらない - even if you... it’s no use;
てもかまわない - it doesn't matter if ~
てもしょうがない - there's no point to~; it's no use to~
と言えば - speaking of; when you talk of~
といい / たらいい - it would be nice if; should; I hope~
といっても - although I say; although one might say~
ということだ - I heard; it means~; in other words~
というのは - this means~; because~; that is to say
と言うと - speaking of; when you say~
というより - rather than~
とみえる / とみえて - it seems that~
とすれば - in the case of~; assuming~; if A then B
と共に - together with; at the same time as
途中で - on the way; in the middle of~
ところで - by the way~
ところが - even so; however; even though~
とおりに - in the same way as; in the way; as~
通す - to do until the end; to continually do
として - as~; in the role of~
とても～ない - cannot possibly be; hardly~
とは限らない - not necessarily so; is not always true
つい - accidentally; unintentionally
ついに - finally ~; at last ~; in the end
ついでに - "while
つまり - in other words; in summary; in short
つもりだった - I thought I~; I believe I did~
つもりで - with the intention of doing~
うちに - while; before~
上で - upon; after; when; for; in order to
上に - as well; not only… but also
は別として - aside from; whether or not~
はもちろん - not to mention; not only; but also~
は～で有名 - famous for~
わけだ - for that reason; no wonder
わけではない - it doesn’t mean that~
わけがない - there is no way that~
わけにはいかない - must not; cannot afford to; must~
割に - considering; relatively; unexpectedly
わざと - on purpose; intentionally~
わざわざ - to go to the trouble of
よりも - rather than~; more than~
ようがない - there is no way to; it’s impossible to~
ような気がする - have a feeling that; feels like; seems like
ように - "in order to
ように見える - to look; to seem; to appear~
ようとしない - not try to; not make an effort to~
ようとする - try to; attempt to; be about to~
ずに - without doing~
ずにはいられない - can’t help but feel; can’t help but do
ずつ - apiece; each; at a time
あげく - to end up; in the end; finally; after all
あるいは - or; either; maybe; perhaps; possibly
ばかり - "about
ばかりだ - continue to (go in negative direction)
ばかりか - not only.. but also; as well as
ばかりに - simply because; on account of
ちなみに - by the way; incidentally
ちっとも～ない - (not) at all; (not) in the least
だけあって - being the case; precisely because
だけましだ - it’s better than; should feel grateful for
だけに - being the case; precisely because
だけのことはある - as expected of; not for nothing
だけは - to do all that one can
だって - because; but; after all; even; too
でしかない - merely; nothing but; no more than
どころではない - not the time for; far from
どころか - far from; anything but; let alone
どうやら - apparently; seems like; somehow
どうせ - anyhow; in any case; at any rate
得ない - unable to; cannot; it is not possible to~
得る - can; to be able to; is possible to~
再び - again; once more
ふうに - this way; that way; in such a way; how
がきっかけで - as a result of; taking advantage of
げ - looks like; seems like; appears to
逆に - conversely; on the contrary
反面 - "while
果たして - as was expected; sure enough; really
一応 - more or less; pretty much; roughly
以外 - with the exception of; excepting
以上に - more than; not less than; beyond
以上は - because; since; seeing that
いきなり - abruptly; suddenly; all of a sudden
一気に - in one go; without stopping; all at once
一方で - "on one hand
いわゆる - what is called; as it is called; so-called
いよいよ - at last; finally; beyond doubt
上 - for the sake of; from the standpoint of
かのように - as if; just like
かと思ったら - just when; no sooner than
か～ないかのうちに - just as; right after; as soon as
かえって - on the contrary; rather; all the more
限り - as long as; while… is the case; as far as
甲斐がある - it’s worth one’s efforts to do something
かねない - (someone) might do something
かねる - unable to do something; can’t do~
から言うと - in terms of; from the point of view of
からこそ - precisely because
から見ると - from the point of view of; judging from
からには - now that; since; so long as; because
からして - judging from; based on; since; from
からすると - judging from; considering
からと言って - just because; even if; even though~
っこない - no chance of; definitely not possible
ことだ - should do~ (suggestions or advice)
ことだから - because; since~
ことか - how…!; what…!
ことなく - without doing something even once
ことに - emphasize speaker's feelings
ことにはならない - just because… doesn’t mean~
くせして - although~; despite the fact that~
まだしも - rather; better
まい - will not; intend not to
ままに - "as
全く～ない - not at all~
もかまわず - without caring; without worrying
も当然だ - it’s only natural; no wonder
もの / もん - because; reason/ excuse/dissatisfaction
ものだ - describe feeling; express memories
ものだから - so; therefore; the reason for something
ものではない - shouldn’t do something; it’s impossible
ものがある - there is such a thing; to be the case
ものか / もんか - as if; there's no way~
ものなら - "if [A] is possible
ものの - but; although; even though~
もっとも - but then; although; though~
もう少しで - "almost; nearly
ないではいられない - can’t help but feel; can’t help but do
ないことには～ない - unless you~
中を /中では - in; on; in the midst of; when; while~
なくはない - it’s not that; I may (double negative)
なくて済む - get by without doing~
何も～ない - nothing; (not) ~ at all
なお - still; yet; furthermore; in addition~
ねばならない - have to do; must; should~
にあたって - at the time; on the occasion of~
にほかならない - nothing but; none other than~
に限らず - not just; not only.. but also~
に限る - is best; nothing is better than~
に限って - only; in particular~
に関わらず - in spite of; regardless of~
に関わる - to relate to; to have to do with
に決まっている - certainly; I’m sure/certain that
に越したことはない - "it’s best that
に応えて - in response to
に加えて - in addition
に基づいて - based on; on the basis of
に向かって - to face; to go towards; to head to
に応じて - depending on; in accordance with
に際して - on the occasion of; at the time of
に先立ち - before; prior to
にせよ/ にしろ - even if; regardless; whether... or
にしろ～にしろ - whether… or~
にしたら - from one’s perspective
にしても - regardless of whether
に沿って - along with; in accordance with
に相違ない - without a doubt; certain; sure
に過ぎない - no more than; just; merely; only~
に伴って - as; due to; with; along with; following
につけ - every time; whenever; as; whether
につき - due to; because of; per; each
にわたって - throughout; over a period of
にも関わらず - despite; in spite of; nevertheless
にて - "in
のももっともだ - no wonder; …is only natural
の下で - under; with~
の上では - according to; from the viewpoint of~
のみならず - not only; besides; as well as~
ぬ - negative verb conjugation (traditional)
抜きにして - without; leaving out; cutting out~
抜く - from beginning to end; completely
を契機に - as a good opportunity/chance to
をめぐって - concerning; in regard to~
をもとに - based on; derived from; building on
を除いて - except; with the exception of
を問わず - regardless of; irrespective of; no matter
お～願う - please do; could you please~
おまけに - to make matters worse; what's more
恐らく - perhaps; likely; probably; I dare say~
恐れがある - it is feared that; to be in danger of
及び - and; as well as~
ろくに～ない - not well; not enough; improperly
幸いなことに - fortunately; luckily; thankfully~
せいか - perhaps because~
せっかく - especially; (thank you for) troubling to
せめて - at least; at most~
次第 - "as soon as
次第で - depending on; so~
次第に - gradually; in sequence; in order
しかも - moreover; furthermore; what’s more~
その上 - besides; in addition; furthermore~
それなのに - and yet; despite this; but even so~
それなら - if that’s the case; if so~
それにしても - nevertheless; at any rate; even so
そう言えば - come to think of it~
そうすると - having done that; if that is done
末に - finally; after; following; at the end
少しも～ない - not one bit; not even a little~
少なくとも - at least~
直ちに - at once; immediately; directly
たまえ - do~; order somebody to do something
てばかりはいられない - can’t keep doing~
てでも - even if I have to; by all means~
て以来 - since; henceforth~
ていては - if one keeps doing~
てこそ - now that; since (something happened)
てまで - even; will go far so as to~
てならない - can't help but; dying to; extremely~
てたまらない - can't help but; dying to; extremely~
て当然だ - natural; as a matter of course
ては / では - whenever; if; when~; repetitive action
てはいられない - can’t afford to; unable to~
てはならない - must not; cannot; should not~
ては～ては - repetitive situations/actions
と同時に - at the same time as; while
といった - like; such as~
というふうに - in such a way that~
ということは - that is to say; in other words~
というものだ - something like; something called~
というものではない - there is no guarantee that~
と考えられる - one can think that; it is conceivable that
とか（で） - I heard that~
とっくに - long ago; already; a long time ago
ところだった - was just about to do something
ところに - at the time; just as I was~
ところを見ると - judging from; seeing that~
とも - even if; no matter; though~
としても - assuming; even if~
つつ - while; even though; despite~
つつある - to be doing; in the process of doing~
上は - now that; since; as long as~
はもとより - also; let alone; from the beginning
はともかく - anyhow; anyway; regardless
わずかに - slightly; only; barely; narrowly~
やがて - before long; soon; almost; eventually~
やら～やら - such things as A and B; and so on~
よほど / よっぽど - very; greatly; much; to a large extent
より [2] - "from~ (a time
よりほかない - to have no choice but~
ようでは - if~ (bad result)
ようではないか - let’s do (something); why don’t we~
ようか～まいか - whether or not; considering options
要するに - in short; in a word; to sum up
ざるを得ない - cannot help (doing); have no choice but
ずに済む - get by without doing~
敢えて - dare to; deliberately; purposely ~
あくまでも - to the end; persistently; is still very ~
案の定 - just as one thought; sure enough
あらかじめ - beforehand; in advance; previously
あっての - which can exist solely due to
ばこそ - only because ~
ばそれまでだ /たらそれまでだ - if… then it’s over
べからず / べからざる - must not; should not; do not ~
べく - in order to; for the purpose of ~
べくもない - cannot possibly be ~
べくして - as it is bound to (happen)
びる / びて / びた - to seem to be; to appear; to behave as ~
ぶり / っぷり - style; manner; way
ぶる / ぶって / ぶった - behaving like; to pretend / act like ~
だに / だにしない - even; not even ~
だの〜だの - and; and the like; and so forth ~
だろうに - "(1) surely...
であれ / であろうと - whoever; whatever; however; even ~
であれ〜であれ - whether [A] or [B]
でもあり〜でもある - to also be; both… and ~
でも何でもない /くも何ともない - not in the least; nothing like that
でなくてなんだろう - must be; is definitely ~
ではあるまいか - isn't it; I wonder if it’s not ~
ではあるまいし - it’s not like; it isn’t as if ~
では済まない - it doesn’t end with just ~
どうにも〜ない - not … by any means
が早いか - no sooner than; as soon as ~
が/も〜なら、〜も〜だ -  ~mo~da
がましい - look like; sound like; somewhat like ~
がてら - while; at the same time; coincidentally
ごとき/ごとく/ごとし - like; as if; the same as ~
ぐるみ - together (with); -wide
羽目になる - to get stuck with (unpleasant)
ほどのことではない - it's not worth; no need to ~
ほうがましだ - better than; would rather ~
放題 - doing as one pleases; uncontrolled
いかんだ / いかんでは/ いかんによっては - in accordance with; depending on ~
いかんにかかわらず /いかんによらず /いかんをとわず - regardless of; whether or not ~
いかなる - any kind of; every; whatever
いかに - how; in what way; to what extent
いかにも - indeed; really; just (like); very ~
いずれにしても / いずれにしろ / いずれにせよ - anyhow; anyway; in any case ~
じみた - to become; to appear like; to look like ~
か否か - whether or not ~
かと思いきや - contrary to expectations
限りだ - to feel strongly
甲斐もなく - despite; even though ~
可能性がある - may/might; there’s a possibility that ~
からある / からする/ からの - at least; as much as; as many as ~
かれ〜かれ - sooner or later; more or less
かたがた - while; at the same time; incidentally ~
かたわら - while; at the same time; in addition
かつて - once; before; formerly; former; ex-
嫌いがある - bad habit; to have a tendency to ~
切りがない - endless; boundless; there’s no end to ~
きっての - the most / greatest … of all
極まる / 極まりない - extremely; very ~
こそあれ - although; even though ~
こそすれ - and; although; but ~
こそ「〜が・けれど」 - but; although (emphasis)
ことごとく - altogether; entirely; completely ~
ことこの上ない / この上ない / この上なく - the most of all; the best; nothing is more ... than ~
こともあって - partly because; also because of ~
ことなしに - without doing something
ことのないように - so as not to; to not ~
こととて - because; since ~
くらいなら - rather than (do ...)
くらいのものだ - only (emphasis)
までだ / までのことだ - only; just; nothing else
までもない / までもなく - there's no need to; not necessary to ~
まじき - should not; must not ~
まくる - to do over and over again
まみれ - covered with; stained; smeared with ~
まるっきり - completely; totally; (not) at all ~
めく - seems; show signs of ~
も同然だ - just like; same as~
もさることながら - not only... but also ~
もしないで - without even doing ~
もはや - already; now; no longer; not anymore
もので - because; for that reason
ものを - if only (regret)
ものと思われる /ものと見られる - to think; to suppose; it is believed/expected that ~
ものとする - shall; to assume; understood as ~
ものとして - to assume; to suppose ~
もしくは - or; otherwise
んばかりに - as if; as though ~
んがために - in order to ~
ながらに / ながらの - while; without change
ないまでも - not to say; does not reach the level of~
ないものでもない - is not entirely impossible
ないものか /ないものだろうか - isn't there; can’t we…?; can’t I…?
ないとも限らない - not necessarily; maybe; might ~
なくしては - cannot do without ~
並み - average; equal to; on par with ~
なんという / なんと/ なんて - "how (beautiful
何しろ - anyway; because; as you know ~
ならでは - distinctive of; uniquely applying to ~
ならいざしらず /はいざしらず - I don't know about ... but ~
なり - as soon as; right after ~
なりに / なりの - suitable; in one's own way/style
なりとも - at least; even just a little
なり〜なり - [A] or [B] or something; for instance ~
なしに / なしで - without; without doing ~
に - and; in addition to
に値する - to be worth; to be worthy of ~
にあって - at; on; during; in the condition of ~
に引き換え - compared to; in contrast to; unlike ~
に至る / に至った - leads to; come to a conclusion
に至るまで - as far as; everything from ... to ~
に至っても - even if; although something ~
に至っては - when it comes to; as for ~
に言わせれば - if you ask; if one may say ~
に限ったことではない - not limited to only ~
にかかっては /にかかったら / にかかると / かかれば - "when handled by (N)
にかかっている - depending on ~
にかこつけて - to use as a pretext; to use as an excuse
にかまけて - to be too busy; to focus only on ~
に難くない - easy to do; it’s not hard to ~
にまつわる - to be related to; to concern with ~
に則って - based on; according to ~
に先駆けて - prior to; being ahead of ~
に忍びない - cannot bring oneself (to do)
にしたところで /としたところで - even if; even supposing that ~
にして - "at/on/under conditions (time
に即して - according to; to be based on ~
に耐える / に耐えない - worth doing; cannot bear doing ~
に足らない/に足りない - cannot; not worthy; not worth doing ~
に足る / に足りる - can do; worthy; worth doing
に照らして - according to; in view of; in light of ~
にとどまらず - not limited to; not only… but also ~
には無理がある - difficult to do; is unreasonable
によらず - regardless of ~
に〜を重ねて - success after continuous (effort)
にもほどがある - to go too far
にも増して - more than…; above ~
には当たらない - it’s not worth; there’s no need to ~
には及ばない - there is no need to; no match for ~
の至り - utmost; extremely ~
の極み - utmost; extremely ~
のなんのって - extremely ~ (cannot express in words)
のやら / ものやら /ことやら - I wonder..; unsure; I don’t know ~
のやら〜のやら - or ~ (I don't know)
を踏まえて - to be based on; to take into account ~
を経て - through; by way of; after; via ~
を控えて - to be soon; the time has come to ~
をいいことに - to take advantage of ~
を顧みず / も顧みず - despite; regardless of ~
を限りに - starting from; the last time
を兼ねて - also for the purpose of ~
を皮切りに - one after another; starting with ~
を機に - as an opportunity/chance to ~
を禁じ得ない - can’t help but; can’t refrain from ~
をものともせずに - in defiance; not losing to/worrying about ~
をもって /をもちまして - by means of; with; on / at / as of (time)
をおいて〜ない - "can only be; no alternative
を押して /を押し切って - to overcome (opposition)
を境に - since ~ (indicates large change)
を余儀なくされる - forced to do something (no choice)
をよそに - despite; without regards to ~
を前提として - with the intention to; on the condition
思いをする - to think; to feel ~
折に - when; at the time; on the occasion ~
およそ - about; roughly; generally; completely ~
さ - ending particle; indicates assertion
さも - "really (seem
さもないと - otherwise; or else; if not ~
さぞ - surely; certainly; no doubt; indeed ~
始末だ - in the end; as a result (negative)
そばから - as soon as; right after ~
そびれる - to miss a chance; to fail to do ~
損なう / 損ねる /損じる - to fail to; miss a chance
術がない - there is no way / means; cannot do ~
すら / ですら - even ~ (with emphasis)
た弾みに /た拍子に - "the moment [A]
たことにする /たことになる - pretend to; contrary to the truth ~
たところで - "even if; no matter (who
たつもりはない - have no intention to / didn't mean to ~
ただ〜のみだ - can do nothing but; only ~
ためしがない - is never the case; have never heard of ~
たら最後 / たが最後 - if you do... negative result
たら〜たで - if / in the case... of course / should ~
たら〜ところだ - "if... (counterfactual)
たりとも - not even; not any ~
たるもの / たる - (that) which is; in capacity of ... should
て敵わない - can't bear to; unable to; troublesome to
てからというもの - ever since ~
てみせる - I’ll do my best; I'll show you ~
てしかるべきだ - should; appropriate; natural to do ~
て済むことではない - ~ is not enough to solve the problem
てやまない - always; never stop; can’t help but ~
手前 - considering; before; one’s standpoint
てもどうにもならない - it's no use; can't do anything
ても差し支えない - can ~; it’s okay if ~ (compromise)
ても知らない - if continue... you'll end up / I don't care
と相まって - "together with...
とあれば - if it is the case that; if ~
とあって - due to the fact that; because of ~
とばかりに - as if to say; as though~
といえども - even if; even though; despite ~
と言えなくもない - it can also be said that ~
といい〜といい - both ... and; whether it be ... or ~
といったらない - extremely; nothing more ... than this
という - all; every single ~ (no exceptions)
というか〜というか - or rather; I mean ~
というもの - during; for; since; over a period of time
というところだ /といったところだ - at the most; no more than; roughly ~
というわけだ - that's why; no wonder ~
というわけではない - it’s not that; it doesn’t mean that ~
といわず〜といわず - "both; not only A or B
ときている - because of ~
とみると - "as soon as one realizes ...
と見るや - at the sight of; after confirming ~
となると / となれば - when it comes to; in such a case
とされる - is considered to; it is said that ~
ときたら - when it comes to; concerning ~
ところを - although (it is a certain time/condition)
ともあろうものが - of all people... (surprise)
ともなく / ともなしに - somehow; without knowing/thinking
ともすれば - apt to (do); tend to; liable to; prone to ~
とも〜とも - unable to draw a conclusion/ judge
とりわけ - especially; above all ~
としたことが - "of all people
とっさに - at once; right away; promptly
とて - even; even if/though ~
とは - I was surprised that; the fact that ~
とはいえ - though; although; nonetheless
とは比べものにならない - can't compare with ~
とは打って変わって/ とは打って変わり - unlike; very different from ~
つ〜つ - and ~ (indicates 2 contrasting actions)
尽くす - to use up (completely)
ってば / ったら - speaking of; I told you already
うちに入らない - not really; can't be regarded as ~
わ - feminine sentence ending particle
はどうであれ - however; whatever ~
はおろか - let alone; needless to say ~
はさておき - setting aside ~
はそっちのけで /をそっちのけで - ignoring (one thing) for (another)
わ〜わで - and (list neg. things happening at same time)
や否や - as soon as; the moment ~
やしない - "should do
やれ〜やれ - give 2 representative examples (negative)
ようが / ようと - even if; no matter how/what ~
ようが〜ようが /ようと〜ようと - no matter; whether; even if [A] or [B]
